WE ./path_to_the_west_texture
NO    ./path_to_the_north_texture
EA ./path_to_the_east_texture
SO ./path_to_the_south_texture

F 255,0,21
C 100,50,200

111  1111111111111111111111111111111111
111110000000000000000000000000000011111111111111111111
    11100000000011111111111111000100011111111111111111111
11111111111111001            111111111111111
    1110000000001            10000000011111111
    1110000000001111111111111110000011111111111111111111
    111000000S0000000000000000000011111111111
    11111111111111111111111111111111    11111