WE ./path_to_the_west_texture
NO ./path_to_the_north_texture
EA ./path_to_the_east_texture
SO ./path_to_the_south_texture

F 200,0,21
C 100,50,3





          11111111111111111111111111111111111111
                   11111000000000000000000000000011111111111111111111
    111000000000000000000000000011111111111111111111
1111111111111100000000000111111111111111
    11100000000000111110000000001111111111111111111
    111000000000001000100000000011111111
    1110000000000111110000000011111111111111111111
    11100000000000000000000N0000011111111111111
          111111111111111111111111111111111111111111
          111