WE ./path_to_the_west_texture
NO ./path_to_the_north_texture
EA ./path_to_the_east_texture
SO ./path_to_the_south_texture

F 200,0,21
C 100,50,200




11111111111111111111111111111111111111111111
111110000000000000000000000000000011111111111111111111
    11100000000011111111111111000000011111111111111111111
11111111111111001             111111111111111
    111000000S001             10000000011111111
    11100000000011111 1111111110000011111111111111111111
    11100000000000000100000000011111111111111
    111111111111111111111111111111111111111111