WE ./path_to_the_west_texture
NO ./path_to_the_north_texture
EA ./path_to_the_east_texture
SO ./path_to_the_south_texture

F 200,0,21
C   100,50,3


        e  F  111e1111111111111111111011111111111
            11111111111100000000000010000000000111111
            11111111111100000000000000000000000111111
                     101
            111111111111111111111111111111111111111111111111
11111
111N11
111111
11111
1111
11111111111111212123434234234234243234243