NO ./png_files/castle.png
SO ./png_files/castle1.png
EA ./png_files/castle2.png
WE ./png_files/castle3.png

C 211,211,211
F 128,128,128


111111111111111
100000000000001
100000111111001
1001001    1001
100100111111001
100100000000001
1000S0000000001
100000000001001
100001001001001
100000000000001
111111111111111