C 211,211,211

F 128,128,128


NO ./png_files/castle2.png
SO ./png_files/castle2.png
EA ./png_files/castle2.png
WE ./png_files/castle2.png



111111111111111
100010000000001
101011011011101
101000001010001
101111101110101
100000100010101
110110111110101
1000100N0000101
101011111011001
101000001010101
101111101110111
100001000000001
111101111110111
100000010000001
111111111111111