NO ./png_files/castle.png
SO ./png_files/castle1.png
EA ./png_files/castle2.png
WE ./png_files/castle3.png

C 211,211,211
F 128,128,128




11111111111111111111111111111111111
111110000000000000000000000000000011
11100000000011111111110000011000000111
11111100000111111   1100000111110011111
111000000S0011111    1000001   1100001
11111111000000011111110000011111000011
1110000000000000000000000000000001111
11111111111111111111111111111111111