NO ./png_files/loa.png
SO ./png_files/castle1.png
EA ./png_files/castle2.png
WE ./png_files/castle3.png

C 211,211,211
F 128,128,128




    11111111111111111111111111111111
111110000000000000000000000000000011
    11100000000011111111111111000001
11111111111111001             111111
    111000000S001             10000111111111
111111110000000111111111111111000011
    11100000000000000000000000011111
    11111111111111111111111111111111